cimetidine	drug
diazepam	drug
dicumarol	drug
disulfiram	drug
phenytoin	drug
alcohol	drug
amiodarone	drug
chlordiazepoxide	drug
estrogens	group
ethosuximide	drug
succinimides	group
sulfonamides	group
phenylbutazone	drug
salicylates	group
methylphenidate	drug
phenothiazines	group
halothane	drug
isoniazid	drug
fluoxetine	drug
H2-antagonists	group
trazodone	drug
tolbutamide	drug
