Serentil	brand
perphenazine	drug
Phenothiazines	group
acetophenazine	drug
Tindal	brand
chlorpromazine	drug
Thorazine	brand
fluphenazine	drug
Prolixin	brand
mesoridazine	brand
Temaril	brand
trimeprazine	drug
Vesprin	brand
triflupromazine	drug
Stelazine	brand
Mellaril	brand
trifluoperazine	drug
Compazine	brand
promazine	drug
Trilafon	brand
prochlorperazine	drug
Phenergan	brand
thioridazine	drug
Sparine	brand
promethazine	drug
